terrain3.png 9 20 50
15 15
8   8   8    8    3    3    3    3    3    3    3    3   3   3   3
8   8   8    8    3    8    8    8    3    3    3    3   0   3   3
8   8   8    8    8    8    0    8    8    8	8    8   8   0   3
3   8   8    8    3    3    3    3    8    3    3    8   3   3   3
3   8   3    8    3    3    3    3    8    3    3    0   3   3   3
3   8   3    8    8    8    8    8    8    8    8    8   3   3   3
3   8   8    8    3    8    3    3    8    3    3    3   3   3   3
3   8   3    3    3    8    3    3    8    3    3    3   3   3   3
3   8   3    3    3    8    0    3    8    3    3    3   3   3   3
3   8   8    8    8    8    3    3    8    8    8    8   8   3   3
3   3   8    3    3    8    3    3    3    8    8    8   8   3   3
3   3   0    3    3    8    8    0    3    8    8    8   8   3   3
3   3   3    3    3    3    3    3    3    8    8    8   8   3   3
3   3   3    3    3    3    3    3    3    3    3    3   3   3   3
3   3   3    3    3    3    3    3    3    3    3    3   3   3   3


