terrain.png 81 63 125
9 9
4	4	4	4	4	4	4	4	4
4	1	1	1	1	4	4	4	4
4	4	1	1	1	1	1	4	4
4	4	1	1	1	1	1	1	1
4	4	1	1	1	1	1	1	1
4	1	1	1	1	1	1	4	4
4	1	1	1	1	1	1	1	4
4	4	1	1	1	1	1	1	4
4	4	1	1	1	1	1	1	4